1 0 0 0 0 0 0 0 0 0 0 0 0 0 0 0 0 0 0 0 0 1
1 0 0 0 0 0 0 0 0 0 0 0 0 0 0 0 0 0 0 0 0 1
1 0 0 0 0 0 0 0 0 0 0 0 0 0 0 0 0 0 0 0 0 1
1 0 100 0 200 0 0 0 0 0 0 0 0 0 0 0 0 0 0 0 0 1
1 1 1 1 1 5 1 0 1 5 1 1 1 1 1 1 0 0 1 1 1 1
1 0 0 0 0 5 0 0 0 5 0 0 0 0 0 0 0 0 0 0 0 1
1 0 0 0 0 5 0 0 0 5 0 0 0 0 0 0 0 0 0 0 0 1
1 0 0 0 0 0 0 5 0 0 0 5 0 0 0 0 0 0 0 0 0 1
1 0 0 0 0 0 0 5 0 0 0 5 0 0 0 0 0 0 0 0 0 1
1 0 0 0 1 1 1 5 1 1 1 5 1 1 1 1 1 1 1 1 1 1
1 0 0 0 1 7 7 7 7 7 7 7 0 0 0 0 0 0 0 0 0 1
1 0 0 0 1 7 7 7 0 7 7 7 0 0 0 0 0 0 0 0 0 1
1 0 0 0 1 0 0 0 0 0 0 0 0 0 0 0 0 0 0 0 0 1
1 0 0 0 1 0 0 0 0 0 0 0 0 0 0 0 0 0 0 0 0 1
1 0 0 0 0 0 0 0 1 0 0 0 0 0 0 0 0 0 0 0 0 1
1 0 0 0 0 0 0 0 1 1 1 1 1 0 0 0 0 0 0 0 0 1
1 0 0 0 0 0 1 1 1 0 0 0 0 0 0 0 0 0 0 0 0 1
1 0 0 0 0 0 0 0 1 0 1 0 1 0 0 0 0 0 0 0 0 1
1 1 1 1 1 1 1 1 1 1 1 1 1 1 1 1 1 1 1 1 1 1